++++++++++++++++++++++++++++++++
++,,,,,,,,,,,,,,,,,,,,,,,,,,,,,+
++,,,,,,,,,,,,,,,,,,,,,,,,,,,,,+
++,,,,,,,,,,,,,,,,,,,,,,,,,,,,,+
++,,,,,,,,,,,,,,,,,,,,,,,,,,,,,+
++,,,,,,,,,,,,,,,,,,,,,,,,,,,,,+
++,,,,,,,,,,,,,,,,,,,,,,,,,,,,,+
++,,,,,,,,,,,,,,,,,,,,,,,,,,,,,+
++,,,,,,,,,,,,,,,,,,,,,,,,,,,,,+
++,,,,,,,,,,,,,,,,,,,,,,,,,,,,,+
++,,,,,,,,,,,,,,,,,,,,,,,,,,,,,+
++,,,,,,,,,,,,,,,,,,,,,,,,,,,,,+
++,,,,,,,,,,,,,,,,,,,,,,,,,,,,,+
++,,,,,,,,,,,,,,,,,,,,,,,,,,,,,+
++,,,,,,,,,,,,,,,,,,,,,,,,,,,,,+
++,,,,,,,,,,,,,,,,,,,,,,,,,,,,,+
++,,,~~~,,,,,,,,,,,,,,,,;;;;;,,+
++,,~...,,,,,,,,,,,,,,,,,,,,,,,+
++,,....,,,,,,,,,,,,,,,,,,,,,,,+
++,,,,8,,,,,,,,,,,,,,,,,,,,,,,,+
++,,;;3;;;;,,,,,,,,,,,,,,,,,,,,+
++,,,,,,,,,,,,,,,,,,,,,,,,,,,,,+
++,,,,,,,,,,,,,,,,,,,,,,,,,,,,,+
++;;;;;;;;;;;;;;;;;;;;;;;;;;;;;+